...#.....#.
##.#.###.#.
.#.#...#...
.#.#.#.###.
...#.#...#.
.#######.#.
.#.......#.
.#.#.#####.
.#.#...#...
.#####.#.##
.......#...
