...#.................#.
##.#.#####.#########.#.
.#.#.#...#.#.........#.
.#.#.###.#.#.#########.
.#.#.....#.#...#.......
.#.#######.###.#####.#.
.#...#...#...#.......#.
.###.#.#.#.#.#########.
...#...#.#.#.#.....#...
##.#####.###.###.#.#.##
.....#.#...#...#.#...#.
.###.#.###.###.#.#####.
.#...#...#.....#.#.....
.#.#####.#######.###.#.
.#.#...........#.....#.
.#.###.#.#############.
.#.....#.#...........#.
.#######.#.#######.###.
.......#.#.#.....#.....
.#####.###.#.###.######
.#...#.#...#...#.#...#.
.###.#.#.#####.#.#.#.#.
.....#.........#...#...
